节日	jiérì	(n) holiday, festival
舅舅	jiùjiu	(n) uncle (mother’s brother)
舅妈	jiùmā	(n) aunt (mother’s brother’s wife)
小区	xiǎoqū	(n) residential development, residential complex
环境	huánjìng	(n) environment, surroundings
除夕	chúxī	(n) Chinese New Year’s Eve
年夜饭	niányèfàn	(n) Chinese New Year’s Eve dinner
墙	qiáng	(n) wall
贴	tiē	(v) to paste, to glue
福	fú	(n) blessing, good fortune
倒	dào	(v) to turn upside down, to go backwards
奇怪	qíguài	(adj) strange, weird
意思	yìsi	(n) meaning
以	yǐ	(prep) with [See Grammar 2.]
代	dài	(v) to replace, to substitute
酒	jiǔ	(n) alcohol, liquor
举	jǔ	(v) to lift, to raise
顺利	shùnlì	(adj) smooth, successful, without a hitch
进步	jìnbù	(v/adj) to make progress; progressive
干杯	gān bēi	(vo) to drink a toast (lit. to dry the cup)
成功	chénggōng	(v/adj) to succeed; successful
晚会	wǎnhuì	(n) evening gathering, soiree
剩（下）	shèng (xia)	(vc) to leave a surplus, to be left (over)
浪费	làngfèi	(v/adj) to waste, to squander; wasteful
余	yú	(n/v) surplus; to have a surplus
传统	chuántǒng	(n/adj) tradition; traditional
农历	nónglì	(n) traditional Chinese lunar calendar (lit. agricultural calendar)
初	chū	first, early part of
粽子	zòngzi	(n) sticky-rice dumpling wrapped in bamboo or reed leaves
月饼	yuèbǐng	(n) moon cake
团圆	tuányuán	(v) to reunite (as a family)
正月	zhēngyuè	(n) first month of the lunar year
元宵	yuánxiāo	(n) night of the fifteenth of the first lunar month, sweet dumplings made of sticky-rice flour
嘛	ma	(p) particle used to emphasize the obvious [See Grammar 3.]
计时	jì shí	(vo) to count time
拜年	bài nián	(vo) to wish somebody a happy Chinese New Year, to pay a Chinese New Year call
恭喜	gōngxǐ	(v) to congratulate
发财	fā cái	(vo) to get rich, to make a fortune
红包	hóngbāo	(n) red envelope containing gift money
热闹	rènao	(adj) lively, buzzing with excitement, bustling with activity (of a place or scene)
鞭炮	biānpào	(n) firecracker
春节	Chūnjié	(pn) Spring Festival, Chinese New Year
端午节	Duānwǔjié	(pn) Dragon Boat Festival
中秋节	Zhōngqiūjié	(pn) Mid-Autumn Festival, Moon Festival
感恩节	Gǎn’ēnjié	(pn) Thanksgiving
元宵节	Yuánxiāojié	(pn) Lantern Festival
变化	biànhuà	(v/n) to change; change
末	mò	(n) end
来不及	lái bu jí	(vc) to not have enough time to do something, to be too late to do something
高（速）铁（路）	gāo(sù) tiě(lù)	(n) high-speed rail
表哥	biǎogē	(n) older male cousin with a different surname
街	jiē	(n) street
盖	gài	(v) to build, to construct
骑	qí	(v) to ride
自行车	zìxíngchē	(n) bicycle
上班	shàng bān	(vo) to go to work, to start work, to be on duty
想像	xiǎngxiàng	(v/n) to imagine, to visualize; imagination
要不是	yàobúshì	(conj) if it were not for, but for
游客	yóukè	(n) tourist
老外	lǎowài	(n) foreigner (slang)
哈哈	hā	(ono) sound of laughter
对面	duìmiàn	(n) opposite side
快餐	kuàicān	(n) fast food
服装	fúzhuāng	(n) clothing, apparel
融入	róngrù	(v) to merge into, to meld into
特色	tèsè	(n) distinguishing feature or quality, characteristic
保留	bǎoliú	(v) to remain as before, to retain
建筑	jiànzhù	(n/v) architecture; to build
尝	cháng	(v) to taste
小吃	xiǎochī	(n) small and inexpensive dishes, snacks
不管	bùguǎn	(conj) no matter, regardless of
变	biàn	(v) to change
民以食为天	mín yǐ shí wéi tiān	ordinary people consider food as important as heaven
句	jù	(m) measure word for sentences
从来	cónglái	(adv) from past till present, always, at all times
老百姓	lǎobǎixìng	(n) ordinary people
尽可能	jǐn kěnéng	as much as possible
厦	shà	(n) mansion, tall building
座	zuò	(m) measure word for buildings, mountains, bridges, cities and other large, solid things
声音	shēngyīn	(n) sound, voice
脚步	jiǎobù	(n) footstep
拍	pāi	(v) to take a picture, to shoot a film
咕噜	gūlū	(ono) rumbling sound
法国	Fǎguó	(pn) France
夫子庙	Fūzǐmiào	(pn) Temple of Confucius
美丽	měilì	(adj) beautiful
留（下）	liú (xia)	(vc) to leave behind, to stay behind
深	shēn	(adj) deep, profound, dark (color)
分享	fēnxiǎng	(v) to share (joy, happiness, benefits, etc.) (lit. to divide and enjoy)
报名	bào míng	(vo) to sign up, to register
参加	cānjiā	(v) to participate, to take part, to attend
团	tuán	(n) group, organization
包括	bāokuò	(v) to include, to consist of
交通	jiāotōng	(n) transportation, traffic (lit. to intersect and go through)
门票	ménpiào	(n) admission ticket, admission fee
旅客	lǚkè	(n) passenger, voyager, traveler
硬	yìng	(adj) hard, stiff
卧铺	wòpù	(n) sleeping bunk (on a train)
车厢	chēxiāng	(n) train carriage
软	ruǎn	(adj) soft
关	guān	(v) to close, to turn off
顿	dùn	(m) measure word for meals
盒饭	héfàn	(n) box lunch
面	miàn	(n) noodles
幽默	yōumò	(adj) humorous
省会	shěnghuì	(n) provincial capital
美	měi	(adj) beautiful, good
饮食	yǐnshí	(n) diet, food and drink
风俗	fēngsú	(n) custom
习惯	xíguàn	(n/v) habit; to be accustomed to
游览	yóulǎn	(v/n) to go sightseeing, to tour; excursion
石头	shítou	(n) stone, rock, pebble
树林	shùlín	(n) woods, forest
讲	jiǎng	(v) to speak, to tell
故事	gùshi	(n) story, tale
塔	tǎ	(n) tower, pagoda
古老	gǔlǎo	(adj) ancient, old
纪念品	jìniànpǐn	(n) souvenir, keepsake, memento
千万	qiānwàn	(adv) by all means, absolutely must
河	hé	(n) river
茶馆	cháguǎn	(n) teahouse
灯笼	dēnglong	(n) lantern
房东	fángdōng	(n) landlord
昆明	Kūnmíng	(pn) Kunming (capital of Yunnan Province)
石林	Shílín	(pn) The Stone Forest
大理	Dàlǐ	(pn) Dali
丽江	Lìjiāng	(pn) Lijiang
与	yǔ	(conj/prep) and; with [See Grammar 2.]
夫妻	fūqī	(n) husband and wife, couple
退休	tuìxiū	(v) to retire
博物馆	bówùguǎn	(n) museum
不必	búbì	(adv) need not, do not need to
散步	sàn bù	(vo) to take a walk, to go for a walk
锻炼	duànliàn	(v) to exercise, to work out, to undergo physical training
广场	guǎngchǎng	(n) public square
太极拳	tàijíquán	(n) tai chi (a form of traditional Chinese shadowboxing)
早晨	zǎochen	(n) morning, early morning
成为	chéngwéi	(v) to become, to turn into
出门	chū mén	(vo) to go out, to leave home
瑜伽	yújiā	(n) yoga
动作	dòngzuò	(n) movement, action
树	shù	(n) tree
重视	zhòngshì	(v) to attach importance to
注意	zhùyì	(v/n) to pay attention to; attention
等等	ěng	(p) and so forth, etc.
健身房	jiànshēnfáng	(n) fitness center, gym
等于	děngyú	(v) to equal, to be equivalent to, to amount to
减肥	jiǎn féi	(vo) to lose weight (lit. to reduce fat)
只要	zhǐyào	(conj) as long as, provided
随便	suíbiàn	(adj/vo) casual, careless; to do as one pleases
即使	jíshǐ	(conj) even if
营养	yíngyǎng	(n) nutrition, nourishment
饱	bǎo	(adj) full, satiated (after a meal)
科学	kēxué	(n/adj) science; scientific
方面	fāngmiàn	(n) aspect, respect
必须	bìxū	(adv) must, have to, be obliged to
吸烟	xī yān	(vo) to smoke a cigarette
熬夜	áo yè	(vo) to stay up late or all night
补充	bǔchōng	(v) to supplement, to replenish
睡眠	shuìmián	(n) sleep
只	zhī	(m) measure word for one of certain paired things and some animals
熊猫	xióngmāo	(n) panda
李文	Lǐ Wén	(pn) Wen Li (a personal name)
平等	píngděng	(adj/n) equal; equality (lit. level and equal)
重男轻女	zhòng nán qīng nǚ	to regard males as superior to females, to privilege men over women
妇女	fùnǚ	(n) women
地位	dìwèi	(n) position, status
情况	qíngkuàng	(n) situation, condition, circumstances
逐渐	zhújiàn	(adv) gradually, little by little
机会	jīhuì	(n) opportunity
改革开放	gǎigé kāifàng	(v/n) to reform and open up; Reform and Opening-Up
以来	yǐlái	(t) since
企业	qǐyè	(n) enterprise, business, company, firm
单位	dānwèi	(n) unit
出现	chūxiàn	(v) to appear, to arise, to emerge
现象	xiànxiàng	(n) phenomenon, appearance
工厂	gōngchǎng	(n) factory
同工同酬	tóng gōng tóng chóu	equal pay for equal work
女性	nǚxìng	(n) female gender, woman
超过	chāoguò	(v) to surpass, to exceed
丈夫	zhàngfu	(n) husband
妻子	qīzi	(n) wife
互相	hùxiāng	(adv) mutually, each other, reciprocally
家务	jiāwù	(n) household chores, household duties
模范	mófàn	(adj/n) exemplary; model, fine example
表现	biǎoxiàn	(v/n) to display, to manifest; performance; manifestation
男子	nánzǐ	(n) man, male
队	duì	(n) team, a row or line of people, (measure word for teams and lines)
讨厌	tǎoyàn	(v/adj) to dislike, to loathe; disgusting, disagreeable
队员	duìyuán	(n) team member
骄傲	jiāo’ào	(adj/n) proud, arrogant, full of oneself; pride
输	shū	(v) to lose, to be defeated
成绩	chéngjì	(n) performance, achievement, result, score, grade
公平	gōngpíng	(adj) fair, just, impartial, equitable
由	yóu	(prep) by
市场	shìchǎng	(n) market
职业	zhíyè	(n) occupation, profession, vocation
薪水	xīnshuǐ	(n) salary, pay, wages
消息	xiāoxi	(n) news, message, information
赢	yíng	(v) to win
冠军	guànjūn	(n) champion, first place in a competition
相信	xiāngxìn	(v) to believe, to trust
比分	bǐfēn	(n) score
乒乓球	pīngpāngqiú	(n) ping pong, table tennis
德国	Déguó	(pn) Germany
西班牙	Xībānyá	(pn) Spain
保护	bǎohù	(v) to protect, to safeguard
节约	jiéyuē	(v) to economize, to save, to conserve
能源	néngyuán	(n) energy, energy source
爬山	pá shān	(vo) to hike in the mountains, to climb a mountain
有益	yǒuyì	(adj) beneficial, useful [See Grammar 4.]
于	yú	(prep) towards, in, on, at, (indicating comparison) [See Grammar 4 and Grammar 5.]
段	duàn	(m) measure word for section, segment, or part
推	tuī	(v) to push, to shove
空气	kōngqì	(n) air, atmosphere
雾霾	wùmái	(n) smog
回收	huíshōu	(v) to recycle
筒	tǒng	(n) thick tube-shaped container
扔	rēng	(v) to throw, to toss, to throw away
瓶装水	píngzhuāng shuǐ	(n) bottled water
地球	dìqiú	(n) the earth, the globe
亮	liàng	(adj) bright, light
太阳	tàiyáng	(n) sun
太阳能	tàiyángnéng	(n) solar energy, solar power
板	bǎn	(n) board, plank, panel
发电	fā diàn	(vo) to generate electricity
国家	guójiā	(n) country, nation
危机	wēijī	(n) crisis
风	fēng	(n) wind
石油	shíyóu	(n) petroleum, oil
煤	méi	(n) coal
规定	guīdìng	(v/n) to regulate, to specify; rules and regulations, provisions
公共场所	gōnggòng chǎngsuǒ	(n) public place or space
暖气	nuǎnqì	(n) heating (lit. warm air)
温度	wēndù	(n) temperature
度	dù	(m) measure word for degrees of temperature, heat, hardness, humidity, etc.
赞成	zànchéng	(v) to approve, to support
出汗	chū hàn	(vo) to sweat
餐具	cānjù	(n) eating utensil, tableware
一次性	yícìxìng	(adj) one-time
砍	kǎn	(v) to cut, to chop
超市	chāoshì	(n) supermarket (short for 超级市场/超級市場)
塑料袋	sùliào dài	(n) plastic bag
减少	jiǎnshǎo	(v) to reduce, to decrease, to lessen
污染	wūrǎn	(v/n) to pollute, to contaminate; pollution, contamination
造成	zào chéng	(vc) to cause, to give rise to
比如	bǐrú	(v) for example
随手	suíshǒu	(adv) without extra effort or motion, conveniently
加油	jiā yóu	(vo) to make an extra effort, to work harder, to refuel
马克	Mǎkè	(pn) Mark
摄氏	Shèshì	(pn) Celsius, centigrade
节俭	jiéjiǎn	(adj) thrifty, frugal
存款	cúnkuǎn	(n/vo) bank savings; to deposit money at a bank
投资	tóu zī	(vo/n) to invest capital; investment (financial) (lit. to throw or cast capital)
理财	lǐcái	(vo) to manage wealth
涨	zhǎng	(v) to rise, to surge, to go up (of water, prices, etc.)
炒股	chǎo gǔ	(vo) to flip stocks
引起	yǐnqǐ	(v) to give rise to, to lead to
思考	sīkǎo	(v/n) to think deeply, to ponder over; contemplation, cogitation
姑妈	gūmā	(n) aunt (father’s sister)
矛盾	máodùn	(n/adj) contradiction, conflict; contradictory, conflicting
郁闷	yùmèn	(adj) gloomy, depressed
省吃俭用	shěng chī jiǎn yòng	to be frugal (with food and other living expenses)
笔	bǐ	(m) measure word for sums of money
孙子	sūnzi	(n) grandson (son’s son)
孙女	sūnnü	(n) granddaughter (son’s daughter)
未婚妻	wèihūnqī	(n) fiancée
算	suàn	(v) to count as, to be considered as
合	hé	(v) to combine, to join
劝	quàn	(v) to persuade, to advise, to urge
辛苦	xīnkǔ	(adj/v) hard, strenuous; to work hard
享受	xiǎngshòu	(v/n) to enjoy; enjoyment, pleasure
老太太	lǎotàitai	(n) elderly lady
利息	lìxī	(n) interest (on invested funds)
增加	zēngjiā	(v) to increase, to add
老年	lǎonián	(n) old age
说服	shuōfú	(v) to persuade, to convince
签	qiān	(v) to sign, to autograph
合同	hétong	(n) agreement, contract
想法	xiǎngfǎ	(n) idea, opinion
突然	tūrán	(adv/adj) suddenly, unexpectedly; sudden, unexpected
义工	yìgōng	(n) volunteer work (lit. righteous work), volunteer
麻将	májiàng	(n) mahjong
赚钱	zhuànqián	(vo) to make a profit
股市	gǔshì	(n) stock market
风险	fēngxiǎn	(n) risk, danger, hazard
抵押	dǐyā	(v) to mortgage
股票	gǔpiào	(n) stock, share (lit. stock certificate)
跌	diē	(v) to fall
赔	péi	(v) to lose (money, etc.), to suffer a loss in a deal
文明	wénmíng	(n/adj) civilization; civilized
之	zhī	(p) literary equivalent of 的
文字	wénzì	(n) characters, written form of a language
记载	jìzǎi	(v/n) to put down in writing, to record; record, account
参观	cānguān	(v) to visit, to look around
其中	qízhōng	among which/whom, in which/whom, of which/whom [See Grammar 2.]
部分	bùfen	(n) portion, part
朝代	cháodài	(n) dynasty
伟大	wěidà	(adj) great, outstanding, magnificent
思想	sīxiǎng	(n) thinking, ideology, thoughts
展厅	zhǎntīng	(n) exhibition hall, gallery
皇帝	huángdì	(n) emperor
统一	tǒngyī	(v/adj) to unify, to unite; unified, centralized
贡献	gòngxiàn	(v/n) to contribute, to devote; contribution
修	xiū	(v) to build, to repair
杀	shā	(v) to kill
烧	shāo	(v) to burn, to set fire to, to cook
宫殿	gōngdiàn	(n) palace
坟墓	fénmù	(n) grave, tomb
兵马俑	bīngmǎyǒng	(n) terracotta warriors and horses
发展	fāzhǎn	(v/n) to develop; development
丝绸	sīchóu	(n) silk, silk fabric
关系	guānxì	(n) relation, relationship, connection
进行	jìnxíng	(v) to carry on, to carry out, to conduct
贸易	màoyì	(n/v) trade; to trade
诗	shī	(n) poetry, poem
诗人	shīrén	(n) poet
发达	fādá	(adj) developed, flourishing
技术	jìshù	(n) technology, technique
曾经	céngjīng	(adv) once; at some time in the past
先进	xiānjìn	(adj) advanced
发明	fāmíng	(n/v) invention; to invent
造纸	zào zhǐ	(vo) to make paper
火药	huǒyào	(n) gunpowder (lit. fire chemical)
指南针	zhǐnánzhēn	(n) compass
活字印刷	huózì yìnshuā	(n) moveable-type printing; letterpress printing
领导	lǐngdǎo	(v/n) to lead; leadership, leader (lit. to lead and guide)
革命	gémìng	(n) revolution
建立	jiànlì	(v) to build, to establish
孔子	Kǒngzǐ	(pn) Confucius
秦朝	Qíncháo	(pn) Qin dynasty
秦始皇	Qínshǐhuáng	(pn) First Emperor of the Qin dynasty
汉朝	Hàncháo	(pn) Han dynasty
西方	Xīfāng	(pn) the West
唐朝	Tángcháo	(pn) Tang dynasty
李白	Lǐ Bái	(pn) Li Bai
宋朝	Sòngcháo	(pn) Song dynasty
清朝	Qīngcháo	(pn) Qing dynasty
孙中山	Sūn Zhōngshān	(pn) Sun Yat-sen
中华民国	Zhōnghuá Mínguó	(pn) Republic of China
世纪	shìjì	(n) century
跨国	kuàguó	(adj) transnational, multinational
进入	jìnrù	(v) to enter, to get into
吸引	xīyǐn	(v) to attract, to draw, to fascinate
人才	réncái	(n) person of ability and talent
国外	guówài	(n) abroad
海外	hǎiwài	(n) overseas
归来	guīlái	(v) to return, to come back
叫做	jiào zuò	(vc) to be called, to be known as
海龟	hǎiguī	(n) sea turtle
满意	mǎnyì	(v) to be satisfied, to be pleased
销售	xiāoshòu	(v) to sell, to market
经理	jīnglǐ	(n) manager
套装	tàozhuāng	(n) suit, a set of matching outer garments
上衣	shàngyī	(n) upper outer garment, jacket
湿	shī	(adj) wet
干吗	gànmá	(qpr) why, why on earth, whatever for
总	zǒng	(adj) general, chief
严肃	yánsù	(adj) stern, serious
吓人	xiàrén	(adj) scary, frightening
解释	jiěshì	(v) to explain
阴	yīn	(adj) overcast, hidden from the sun
转	zhuǎn	(v) to turn, to shift, to change
云	yún	(n) cloud
寄	jì	(v) to mail, to send
录用	lùyòng	(v) to take someone on staff, to employ
通知	tōngzhī	(n/v) notice; to notify, to inform
既然	jìrán	(conj) since, as, now that [See Grammar 2.]
接着	jiēzhe	(v) to follow, to continue
回答	huídá	(v) to reply, to answer
短期	duǎnqī	(n) short term
好在	hǎozài	(adv) fortunately, luckily
产品	chǎnpǐn	(n) product, merchandise
晴	qíng	(adj) sunny
缺点	quēdiǎn	(n) shortcoming, defect, weakness
零食	língshí	(n) snack
善于	shànyú	(v) to be good at, to be adept in
往往	wǎngwǎng	(adv) more often than not
加班	jiā bān	(vo) to work overtime, to work extra shifts
优点	yōudiǎn	(n) merit, strong point, advantage
可怕	kěpà	(adj) awful, terrible, fearful
握手	wò shǒu	(vo) to shake hands, to clasp hands
能力	nénglì	(n) ability, capacity, competence
周	zhōu	(n) week
聚会	jùhuì	(v/n) to get together, to congregate; party, get-together, social gathering
庆祝	qìngzhù	(v) to celebrate
接受	jiēshòu	(v) to accept, to take on, to undertake
接风	jiēfēng	(v) to host a welcome meal for a visitor from afar
饯行	jiànxíng	(v) to host a farewell meal
客人	kèren	(n) guest, visitor
火锅	huǒguō	(n) hotpot
聚	jù	(v) to gather, to get together, to congregate
出差	chū chāi	(vo) to be away on business or on a business trip
推销	tuīxiāo	(v) to market, to promote the sale (of goods/merchandise)
电池	diànchí	(n) battery
火	huǒ	(adj/n) thriving, flourishing; fire, flame
校友	xiàoyǒu	(n) schoolmate, alumnus, alumna
关照	guānzhào	(v) to take care of, to look after
同事	tóngshì	(n) colleague, coworker
者	zhě	(suffix) meaning “person”
电视剧	diànshìjù	(n) TV drama, TV series
搞	gǎo	(v) to do, to carry on, to be engaged in
面熟	miànshú	(adj) familiar-looking
流	liú	(n) class, level, rank, category
演员	yǎnyuán	(n) actor, performer
而已	éryǐ	(p) and no more
稳定	wěndìng	(adj/v) stable, steady; to stabilize, to be steady
年轻	niánqīng	(adj) young
永远	yǒngyuǎn	(adv) always, forever
放心	fàng xīn	(vo) to feel relieved, to be at ease
联系	liánxì	(v/n) to contact, to get in touch; connection, relation (lit. to combine and tie)
友谊	yǒuyì	(n) friendship
欧洲	Ōuzhōu	(pn) Europe